1111111111111111111111111111111111
1E00010000000C1C001000000000C10001
1000010100100011101001111111110101
1111011001101110001000000000C10101
1P0000001C0000001000010000000001C1
1111111111111111111111111111111111